EWD	KEYWORD1	DATA_TYPE
ESP32_easy_wifi_data	KEYWORD1	DATA_TYPE
routerName	LITERAL2
routerPass	LITERAL2
APPass	LITERAL2
wifiPort	LITERAL2
APPort	LITERAL2
APName	LITERAL2
connDelay	LITERAL2
connectToNetwork	LITERAL2
wifiRestartNotHotspot	LITERAL2
signalLossTimeout	LITERAL2
debugPrint	LITERAL2
beClientNotServer	LITERAL2
hotspotAddress	LITERAL2
serverAddr	LITERAL2
blockSimultaneousConnections	LITERAL2
millisSinceMessage	KEYWORD2
notTimedOut	KEYWORD2
timedOut	KEYWORD2
newData	KEYWORD2
setupWifi	KEYWORD2
runWifiCommunication	KEYWORD2
recvBl	KEYWORD2
recvBy	KEYWORD2
recvIn	KEYWORD2
recvFl	KEYWORD2
sendBl	KEYWORD2
sendBy	KEYWORD2
sendIn	KEYWORD2
sendFl	KEYWORD2
EWDmaxWifiSendBufSize	LITERAL1
EWDmaxWifiRecvBufSize	LITERAL1